b	不 不是
bi	并 必须
p	跑 朋友
pi	批 平均
m	们 没有
mi	名 明显
f	法 发展
d	的 但是
di	地 地方
du	对 对于
t	他 他们
ti	条 条件
tu	同 通过
n	那 那么
ni	你 你们
nu	弄 农业
nv	女 女人
l	了 来说
li	两 历史
lu	路 落后
lv	率 绿色
g	个 各种
gu	过 工作
k	看 可以
ku	快 控制
h	和 还是
hu	或 活动
ji	就 就是
jv	句 具有
qi	其 起来
qv	去 全国
xi	小 现在
xv	学 需要
zh	这 这个
zhu	中 主要
ch	成 成为
chu	出 出来
sh	是 什么
shu	说 水平
r	人 人们
ru	如 如果
z	在 自己
zu	最 作用
c	才 才能
cu	从 存在
s	三 思想
su	所 所以
rj	而 而且
rji	一 一个
rju	我 我们
rjv	与 于是
